# # # # # # # # # # # # # # # # # # # # # # # # # # # # # # # # # # # # # # # # # # # # # # # # # # # # #
# E #                       #                   #                                               #       #
#   #   # # # # # # # # #   #   # # # # #   #   # # # # #   # # # # # # # # # # # # # # # # #   #   #   #
#   #       #   #           #   #           #               #       #                   #   #   #   #   #
#   # # #   #   #   # # # # # # #   # # # # # # # # # # # # #   # # #   # # # # #   #   #   #   #   #   #
#           #   #               #   #           #       #               #           #       #   #   #   #
# # # # # # #   # # # # # # #   #   #   # # #   #   #   # # #   # # # # #   # # # # # # #   #   # # #   #
#               #               #           #       #       #       #       #       #       #       #   #
#   # # # # # # #   # # # # # # # # # # # # # # # # # # #   # # # # #   # # #   # # #   # # # # #   #   #
#                   #       #               #               #           #       #       #           #   #
#   # # # # # # # # #   #   #   #   # # #   #   # # # # # # #   # # # # #   # # #   # # #   # # # # #   #
#               #       #   #   #   #       #   #       #       #           #           #   #       #   #
# # # # # # #   # # #   #   #   #   #   # # #   #   # # #   #   # # # # #   #   # # # # #   #   #   #   #
#   #       #           #   #   #   #           #   #       #   #       #       #   #       #   #       #
#   #   #   # # # # # # #   # # #   # # # # # # #   #   # # #   #   #   #   # # #   #   # # #   # # #   #
#       #               #       #   #                   #   #       #   #           #   #       #   #   #
#   # # # # # # #   # # # # #   #   #   # # # # # # # # #   # # # # #   # # # # #   #   #   # # #   #   #
#   #           #   #       #   #   #                   #       #       #       #   #   #       #   #   #
#   #   # # #   #   #   #   #   #   # # # # # # # # #   # # #   #   # # #   #   # # #   # # #   #   #   #
#       #       #       #           #                           #           #                   #       #
# # # # # # # # # # # # # # # # # # # # # # # # # # # # # # # # # # # # # # # # # # # # # # # # # # # # #
